0 1 31 31 31 31 31 2 31 31 31 31 31 31 31 31 31 31 31 20
2 2 23 20 21 2 1 2 2 2 2 2 2 2 2 2 2 2 2
2 2 23 20 21 2 1 2 2 2 2 2 2 2 2 2 2 2 2
2 2 23 20 21 2 1 2 2 2 2 2 2 2 2 2 2 2 2
2 2 23 20 21 2 1 2 2 2 2 2 2 2 2 2 2 2 2
1 2 2 2 10 11 12 13 14 22 2 2 2 2 2 2 2 2 2 2
2 2 23 20 21 2 1 2 2 2 2 2 2 2 2 2 2 2 2
2 2 23 20 21 2 1 2 2 2 2 2 2 2 2 2 2 2 2
2 2 23 20 21 2 1 2 2 2 2 2 2 2 2 2 2 2 2
2 2 23 20 21 2 1 2 2 2 2 2 2 2 2 2 2 2 2
1 2 2 2 10 11 12 13 14 22 2 2 2 2 2 2 2 2 2 2
2 2 23 20 21 2 1 2 2 2 2 2 2 2 2 2 2 2 2
2 2 23 20 21 2 1 2 2 2 2 2 2 2 2 2 2 2 2
2 2 23 20 21 2 1 2 2 2 2 2 2 2 2 2 2 2 2
2 2 23 20 21 2 1 2 2 2 2 2 2 2 2 2 2 2 2